{
  "rooms": [
    {
      "roomNumber": 101,
      "capacity": 30,
      "schedule": {}
    },
    {
      "roomNumber": 102,
      "capacity": 30,
      "schedule": {}
    },
    {
      "roomNumber": 201,
      "capacity": 40,
      "schedule": {}
    },
    {
      "roomNumber": 202,
      "capacity": 40,
      "schedule": {}
    }
  ],
  "911": {
    "type": "일반실",
    "월": {
      "09:00": "O",
      "10:00": "O",
      "11:00": "O",
      "12:00": "O",
      "13:00": "O",
      "14:00": "O",
      "15:00": "O",
      "16:00": "O"
    },
    "화": {
      "09:00": "O",
      "10:00": "O",
      "11:00": "O",
      "12:00": "O",
      "13:00": "O",
      "14:00": "O",
      "15:00": "O",
      "16:00": "O"
    },
    "수": {
      "09:00": "O",
      "10:00": "O",
      "11:00": "O",
      "12:00": "O",
      "13:00": "O",
      "14:00": "O",
      "15:00": "O",
      "16:00": "O"
    },
    "목": {
      "09:00": "O",
      "10:00": "O",
      "11:00": "O",
      "12:00": "O",
      "13:00": "O",
      "14:00": "O",
      "15:00": "O",
      "16:00": "O"
    },
    "금": {
      "09:00": "O",
      "10:00": "O",
      "11:00": "O",
      "12:00": "O",
      "13:00": "O",
      "14:00": "O",
      "15:00": "O",
      "16:00": "O"
    }
  },
  "912": {
    "type": "일반실",
    "월": {
      "09:00": "O",
      "10:00": "O",
      "11:00": "X",
      "12:00": "O",
      "13:00": "O",
      "14:00": "X",
      "15:00": "O",
      "16:00": "O"
    },
    "화": {
      "09:00": "O",
      "10:00": "O",
      "11:00": "O",
      "12:00": "O",
      "13:00": "O",
      "14:00": "O",
      "15:00": "O",
      "16:00": "O"
    },
    "수": {
      "09:00": "O",
      "10:00": "O",
      "11:00": "O",
      "12:00": "O",
      "13:00": "O",
      "14:00": "O",
      "15:00": "O",
      "16:00": "O"
    },
    "목": {
      "09:00": "O",
      "10:00": "O",
      "11:00": "O",
      "12:00": "O",
      "13:00": "O",
      "14:00": "O",
      "15:00": "O",
      "16:00": "O"
    },
    "금": {
      "09:00": "O",
      "10:00": "O",
      "11:00": "O",
      "12:00": "O",
      "13:00": "O",
      "14:00": "O",
      "15:00": "O",
      "16:00": "O"
    }
  }
}